#### Civilisation Names (maximum of 64 Civilisations) ####


##### kjm 021699 - added - this goes into the investigate diplomacy screen
PERSONALITY_DESCRIPTION_BARBARIAN	"Bárbaro"
PERSONALITY_DESCRIPTION_SLAVER	"Negrero"
PERSONALITY_DESCRIPTION_CLERIC	"Religioso"
PERSONALITY_DESCRIPTION_WAR_MANY	"Militante"
PERSONALITY_DESCRIPTION_WAR_FEW	"Agresivo"
PERSONALITY_DESCRIPTION_SCI_MANY	"Pacífico"
PERSONALITY_DESCRIPTION_SCI_FEW	"Agradable" 

TEMP_LEADER_NAME_FEMALE	"Juana de Arco"

PRONOUN_HE_MALE	"él"
PRONOUN_HE_FEMALE	"ella"
PRONOUN_HIM_MALE	"a él"
PRONOUN_HIM_FEMALE	"a ella"
PRONOUN_HIS_MALE	"su"
PRONOUN_HIS_FEMALE	"su"
	
PRONOUN_HE_MALE_CAP	"Él"
PRONOUN_HE_FEMALE_CAP	"Ella"
PRONOUN_HIM_MALE_CAP	"A él"
PRONOUN_HIM_FEMALE_CAP	"A ella"
PRONOUN_HIS_MALE_CAP	"Su"
PRONOUN_HIS_FEMALE_CAP	"Su"

# emissary photos
#
#GREEK_DIPLOMAT_PHOTO	"upd023.tga"
#AMERICAN_DIPLOMAT_PHOTO	"upd010.tga"
#SCOTTISH_DIPLOMAT_PHOTO	"upd044.tga"
#IRISH_DIPLOMAT_PHOTO	"upd028.tga"
#ENGLISH_DIPLOMAT_PHOTO	"upd019.tga"
#NATIVE_AMERICAN_DIPLOMAT_PHOTO	"upd035.tga"
#GERMAN_DIPLOMAT_PHOTO	"upd022.tga"
#FRENCH_DIPLOMAT_PHOTO	"upd021.tga"
#JAPANESE_DIPLOMAT_PHOTO	"upd030.tga"
#CHINESE_DIPLOMAT_PHOTO	"upd015.tga"
#RUSSIAN_DIPLOMAT_PHOTO	"upd043.tga"
#SPANISH_DIPLOMAT_PHOTO	"upd045.tga"
#PORTUGUESE_DIPLOMAT_PHOTO	"upd041.tga"
#DUTCH_DIPLOMAT_PHOTO	"upd017.tga"
#VIKING_DIPLOMAT_PHOTO	"upd048.tga"
#ROMAN_DIPLOMAT_PHOTO	"upd042.tga"
#EGYPTIAN_DIPLOMAT_PHOTO	"upd018.tga"
#PERSIAN_DIPLOMAT_PHOTO	"upd038.tga"
#TURKISH_DIPLOMAT_PHOTO	"upd047.tga"
#PHOENICIAN_DIPLOMAT_PHOTO	"upd039.tga"
#WELSH_DIPLOMAT_PHOTO	"upd049.tga"
#CUBAN_DIPLOMAT_PHOTO	"upd016.tga"
#ZULU_DIPLOMAT_PHOTO	"upd050.tga"
#HEBREW_DIPLOMAT_PHOTO	"upd024.tga"
#ASSYRIAN_DIPLOMAT_PHOTO	"upd011.tga"
#INDIAN_DIPLOMAT_PHOTO	"upd026.tga"
#THAI_DIPLOMAT_PHOTO	"upd046.tga"
#POLYNESIAN_DIPLOMAT_PHOTO	"upd040.tga"
#INDONESIAN_DIPLOMAT_PHOTO	"upd027.tga"
#JAMAICAN_DIPLOMAT_PHOTO	"upd029.tga"
#INCAN_DIPLOMAT_PHOTO	"upd025.tga"
#MAYAN_DIPLOMAT_PHOTO	"upd032.tga"
#CANADIAN_DIPLOMAT_PHOTO	"upd014.tga"
#NIGERIAN_DIPLOMAT_PHOTO	"upd037.tga"
#KOREAN_DIPLOMAT_PHOTO	"upd031.tga"
#BRAZILIAN_DIPLOMAT_PHOTO	"upd013.tga"
#AUSTRALIAN_DIPLOMAT_PHOTO	"upd012.tga"
#MEXICAN_DIPLOMAT_PHOTO	"upd033.tga"
#ETHIOPIAN_DIPLOMAT_PHOTO	"upd020.tga"
#MONGOLIAN_DIPLOMAT_PHOTO	"upd034.tga"
#NICARAGUAN_DIPLOMAT_PHOTO	"upd036.tga"



AFRICAN_MAN_PHOTO	"upd010.tga"
	
	
BARBARIAN	"Bárbaros"
	
BARBARIAN_LEADERM_NAME	"Atila"
BARBARIAN_LEADERF_NAME	"Tannis"
BARBARIAN_SINGULAR	"Bárbaro"
BARBARIAN_PLURAL	"Bárbaros"
BARBARIAN_COUNTRY_NAME	"Los Páramos"
BARBARIAN_CITY_1	"Vándalos"
BARBARIAN_CITY_2	"Ostrogodos"
BARBARIAN_CITY_3	"Visigodos"
BARBARIAN_CITY_4	"Borgoñeses"
BARBARIAN_CITY_5	"Langobardos"
BARBARIAN_CITY_6	"Pictos"
BARBARIAN_CITY_7	"Hunos"
BARBARIAN_CITY_8	"Celtas"
BARBARIAN_CITY_9	"Noruegos"
BARBARIAN_CITY_10	"Galos"
BARBARIAN_CITY_11	"Alamanos"
BARBARIAN_CITY_12	"Jutes"
BARBARIAN_CITY_13	"Anglos"
BARBARIAN_CITY_14	"Sajones"
BARBARIAN_CITY_15	"Macomanos"
BARBARIAN_CITY_16	"Cheruscos"
BARBARIAN_CITY_17	"Francos"
BARBARIAN_CITY_18	"Teutones"
BARBARIAN_CITY_19	"Búlgaros"
BARBARIAN_CITY_20	"Alamanes"
BARBARIAN_CITY_21	"Suevios"
BARBARIAN_CITY_22	"Frisios"
BARBARIAN_CITY_23	"Avares"
BARBARIAN_CITY_24	"Magyares"
BARBARIAN_CITY_25	"Gepidos"
BARBARIAN_CITY_26	"Alanos"
BARBARIAN_CITY_27	"Rugianos"
BARBARIAN_CITY_28	"Suevos"
BARBARIAN_CITY_29	"Lombardos"
BARBARIAN_CITY_30	"Turingios"
	
	
GREEK	"Griegos"
	
GREEK_LEADERM_NAME	"Alejandro Magno"
GREEK_LEADERF_NAME	"Helena"
GREEK_COUNTRY_NAME	"Grecia"
GREEK_SINGULAR	"Griego"
GREEK_PLURAL	"Griegos"
GREEK_CITY_1	"Atenas"
GREEK_CITY_2	"Esparta"
GREEK_CITY_3	"Corinto"
GREEK_CITY_4	"Olimpia"
GREEK_CITY_5	"Troya"
GREEK_CITY_6	"Delfos"
GREEK_CITY_7	"Argos"
GREEK_CITY_8	"Rodas"
GREEK_CITY_9	"Micenas"
GREEK_CITY_10	"Pilos"
GREEK_CITY_11	"Knossos"
GREEK_CITY_12	"Bizancio"
GREEK_CITY_13	"Mileto"
GREEK_CITY_14	"Megara"
GREEK_CITY_15	"Maratón"
GREEK_CITY_16	"Termópilas"
GREEK_CITY_17	"Salónica"
GREEK_CITY_18	"Estagira"
GREEK_CITY_19	"Anactorium"
GREEK_CITY_20	"Corfú"
GREEK_CITY_21	"Epidauro"
GREEK_CITY_22	"Halicarnaso"
GREEK_CITY_23	"Polidaea"
GREEK_CITY_24	"Tegea"
GREEK_CITY_25	"Mitilene"
GREEK_CITY_26	"Amphipolis"
GREEK_CITY_27	"Éfeso"
GREEK_CITY_28	"Melos"
GREEK_CITY_29	"Filipos"
GREEK_CITY_30	"Lesbos"
	
	
AMERICANS	"Estadounidenses"
	
AMERICAN_LEADERM_NAME	"George Washington"
AMERICAN_LEADERF_NAME	"Susan B. Anthony"
AMERICAN_COUNTRY_NAME	"Estados Unidos"
AMERICAN_SINGULAR	"Estadounidense"
AMERICAN_PLURAL	"Estadounidenses"
AMERICAN_CITY_1	"Washington D.C."
AMERICAN_CITY_2	"Boston"
AMERICAN_CITY_3	"Filadelfia"
AMERICAN_CITY_4	"Nueva York"
AMERICAN_CITY_5	"San Francisco"
AMERICAN_CITY_6	"Atlanta"
AMERICAN_CITY_7	"Chicago"
AMERICAN_CITY_8	"Richmond"
AMERICAN_CITY_9	"San Diego"
AMERICAN_CITY_10	"Newport Beach"
AMERICAN_CITY_11	"Nueva Orleans"
AMERICAN_CITY_12	"Miami"
AMERICAN_CITY_13	"Minneápolis"
AMERICAN_CITY_14	"Detroit"
AMERICAN_CITY_15	"Cleveland"
AMERICAN_CITY_16	"Indianápolis"
AMERICAN_CITY_17	"Milwaukee"
AMERICAN_CITY_18	"Springfield"
AMERICAN_CITY_19	"Little Rock"
AMERICAN_CITY_20	"Los Ángeles"
AMERICAN_CITY_21	"Las Vegas"
AMERICAN_CITY_22	"Baltimore"
AMERICAN_CITY_23	"Nashville"
AMERICAN_CITY_24	"Anchorage"
AMERICAN_CITY_25	"Dallas"
AMERICAN_CITY_26	"Omaha"
AMERICAN_CITY_27	"Denver"
AMERICAN_CITY_28	"Portland"
AMERICAN_CITY_29	"Seattle"
AMERICAN_CITY_30	"Santa Fe"
	
	
SCOTTISH	"Escoceses"
	
SCOTTISH_LEADERM_NAME	"William Wallace"
SCOTTISH_LEADERF_NAME	"María Estuardo"
SCOTTISH_COUNTRY_NAME	"Escocia"
SCOTTISH_SINGULAR	"Escocés"
SCOTTISH_PLURAL	"Escoceses"
SCOTTISH_CITY_1	"Glasgow"
SCOTTISH_CITY_2	"Edinburgo"
SCOTTISH_CITY_3	"Stirling"
SCOTTISH_CITY_4	"Perth"
SCOTTISH_CITY_5	"Falkirk"
SCOTTISH_CITY_6	"Dunbar"
SCOTTISH_CITY_7	"Muir of Ord"
SCOTTISH_CITY_8	"Gairloch"
SCOTTISH_CITY_9	"Aberdeen"
SCOTTISH_CITY_10	"Kilmarnock"
SCOTTISH_CITY_11	"Cowdenbeath"
SCOTTISH_CITY_12	"Nairn"
SCOTTISH_CITY_13	"Bathgate"
SCOTTISH_CITY_14	"Linlithgow"
SCOTTISH_CITY_15	"Inverness"
SCOTTISH_CITY_16	"Melrose"
SCOTTISH_CITY_17	"Rothesay"
SCOTTISH_CITY_18	"Monifieth"
SCOTTISH_CITY_19	"Aviemore"
SCOTTISH_CITY_20	"Kirkcaldy"
SCOTTISH_CITY_21	"Fraserburgh"
SCOTTISH_CITY_22	"Portlethen"
SCOTTISH_CITY_23	"Glenrothes"
SCOTTISH_CITY_24	"Dufftown"
SCOTTISH_CITY_25	"Findhorn"
SCOTTISH_CITY_26	"Borgue"
SCOTTISH_CITY_27	"Lockerbie"
SCOTTISH_CITY_28	"Dalkeith"
SCOTTISH_CITY_29	"Gretna"
SCOTTISH_CITY_30	"Dingwall"
	
	
IRISH	"Irlandeses"
	
IRISH_LEADERM_NAME	"Brian Boru"
IRISH_LEADERF_NAME	"Isabella Gregon"
IRISH_COUNTRY_NAME	"Irlanda"
IRISH_SINGULAR	"Irlandés"
IRISH_PLURAL	"Irlandeses"
IRISH_CITY_1	"Dublín"
IRISH_CITY_2	"Blarney"
IRISH_CITY_3	"Waterford"
IRISH_CITY_4	"Cork"
IRISH_CITY_5	"Limerick"
IRISH_CITY_6	"Galway"
IRISH_CITY_7	"Donegal Town"
IRISH_CITY_8	"Sligo"
IRISH_CITY_9	"Allenwood"
IRISH_CITY_10	"Glaslough"
IRISH_CITY_11	"Killinick"
IRISH_CITY_12	"Portmarnock"
IRISH_CITY_13	"Newbridge"
IRISH_CITY_14	"Wicklow"
IRISH_CITY_15	"Dunshaughlin"
IRISH_CITY_16	"Midleton"
IRISH_CITY_17	"Glencullen"
IRISH_CITY_18	"Tallaght"
IRISH_CITY_19	"Arklow"
IRISH_CITY_20	"Blackrock"
IRISH_CITY_21	"Macroom"
IRISH_CITY_22	"Kiltimagh"
IRISH_CITY_23	"Ballyknockan"
IRISH_CITY_24	"Monaghan"
IRISH_CITY_25	"Dunkineely"
IRISH_CITY_26	"Rathgormack"
IRISH_CITY_27	"Mullingar"
IRISH_CITY_28	"Clifden"
IRISH_CITY_29	"Edenderry"
IRISH_CITY_30	"Skibbereen"
	
	
ENGLISH	"Ingleses"
	
ENGLISH_LEADERM_NAME	"Winston Churchill"
ENGLISH_LEADERF_NAME	"Isabel I"
ENGLISH_COUNTRY_NAME	"Inglaterra"
ENGLISH_SINGULAR	"Inglés"
ENGLISH_PLURAL	"Ingleses"
ENGLISH_CITY_1	"Londres"
ENGLISH_CITY_2	"Birmingham"
ENGLISH_CITY_3	"Canterbury"
ENGLISH_CITY_4	"Manchester"
ENGLISH_CITY_5	"Liverpool"
ENGLISH_CITY_6	"Cambridge"
ENGLISH_CITY_7	"Bedford"
ENGLISH_CITY_8	"Winchester"
ENGLISH_CITY_9	"York"
ENGLISH_CITY_10	"Norwich"
ENGLISH_CITY_11	"Worcester"
ENGLISH_CITY_12	"Hastings"
ENGLISH_CITY_13	"Brighton"
ENGLISH_CITY_14	"Stratford"
ENGLISH_CITY_15	"Oxford"
ENGLISH_CITY_16	"Gloucester"
ENGLISH_CITY_17	"Bath"
ENGLISH_CITY_18	"Newcastle"
ENGLISH_CITY_19	"Southampton"
ENGLISH_CITY_20	"Portsmouth"
ENGLISH_CITY_21	"Coventry"
ENGLISH_CITY_22	"Derby"
ENGLISH_CITY_23	"Exeter"
ENGLISH_CITY_24	"Leeds"
ENGLISH_CITY_25	"St.Ives"
ENGLISH_CITY_26	"Dover"
ENGLISH_CITY_27	"Shrewsbury"
ENGLISH_CITY_28	"Lincoln"
ENGLISH_CITY_29	"Richmond"
ENGLISH_CITY_30	"Bristol"
	
	
NATIVE_AMERICAN	"Indios americanos"
### North America primarily	
NATIVE_AMERICAN_LEADERM_NAME	"Toro Sentado"
NATIVE_AMERICAN_LEADERF_NAME	"Pocahontas"
NATIVE_AMERICAN_COUNTRY_NAME	"América del Norte"
NATIVE_AMERICAN_SINGULAR	"Indio americano"
NATIVE_AMERICAN_PLURAL	"Indios americanos"
NATIVE_AMERICAN_CITY_1	"Sioux"
NATIVE_AMERICAN_CITY_2	"Cherokee"
NATIVE_AMERICAN_CITY_3	"Mohawk"
NATIVE_AMERICAN_CITY_4	"Iroquois"
NATIVE_AMERICAN_CITY_5	"Navajo"
NATIVE_AMERICAN_CITY_6	"Apache"
NATIVE_AMERICAN_CITY_7	"Seminole"
NATIVE_AMERICAN_CITY_8	"Nez Perce"
NATIVE_AMERICAN_CITY_9	"Cheyenne"
NATIVE_AMERICAN_CITY_10	"Comanche"
NATIVE_AMERICAN_CITY_11	"Inuit"
NATIVE_AMERICAN_CITY_12	"Chickasaw"
NATIVE_AMERICAN_CITY_13	"Hopi"
NATIVE_AMERICAN_CITY_14	"Blackfoot"
NATIVE_AMERICAN_CITY_15	"Havasupai"
NATIVE_AMERICAN_CITY_16	"Kiowa"
NATIVE_AMERICAN_CITY_17	"Ojibwe"
NATIVE_AMERICAN_CITY_18	"Wyandot"
NATIVE_AMERICAN_CITY_19	"Secwepemc"
NATIVE_AMERICAN_CITY_20	"Zuni"
NATIVE_AMERICAN_CITY_21	"Tulalip"
NATIVE_AMERICAN_CITY_22	"Powhatan"
NATIVE_AMERICAN_CITY_23	"Shinnecock"
NATIVE_AMERICAN_CITY_24	"Taino"
NATIVE_AMERICAN_CITY_25	"Choctaw"
NATIVE_AMERICAN_CITY_26	"Abenaki"
NATIVE_AMERICAN_CITY_27	"Chumash"
NATIVE_AMERICAN_CITY_28	"Potawatomi"
NATIVE_AMERICAN_CITY_29	"Umpqua"
NATIVE_AMERICAN_CITY_30	"Mechoopda"
	
	
GERMAN	"Alemanes"
	
GERMAN_LEADERM_NAME	"Federico"
GERMAN_LEADERF_NAME	"Brunhilda"
GERMAN_COUNTRY_NAME	"Alemania"
GERMAN_SINGULAR	"Alemán"
GERMAN_PLURAL	"Alemanes"
GERMAN_CITY_1	"Berlín"
GERMAN_CITY_2	"Múnich"
GERMAN_CITY_3	"Hamburgo"
GERMAN_CITY_4	"Bremen"
GERMAN_CITY_5	"Leipzig"
GERMAN_CITY_6	"Francfort"
GERMAN_CITY_7	"Dusseldorf"
GERMAN_CITY_8	"Hanóver"
GERMAN_CITY_9	"Essenheim"
GERMAN_CITY_10	"Stuttgart"
GERMAN_CITY_11	"Colonia"
GERMAN_CITY_12	"Dortmund"
GERMAN_CITY_13	"Heidelberg"
GERMAN_CITY_14	"Nuremburg"
GERMAN_CITY_15	"Bonn"
GERMAN_CITY_16	"Duisberg"
GERMAN_CITY_17	"Bacharach"
GERMAN_CITY_18	"Saarbrucken"
GERMAN_CITY_19	"Berchtesgaden"
GERMAN_CITY_20	"Magdeburg"
GERMAN_CITY_21	"Wurzburgo"
GERMAN_CITY_22	"Kaiserslautern"
GERMAN_CITY_23	"Kiel"
GERMAN_CITY_24	"Koblenz"
GERMAN_CITY_25	"Halle"
GERMAN_CITY_26	"Muenster"
GERMAN_CITY_27	"Dresden"
GERMAN_CITY_28	"Gunzburg"
GERMAN_CITY_29	"Schwetzingen"
GERMAN_CITY_30	"Warstein"
	
	
FRENCH	"Franceses"
	
FRENCH_LEADERM_NAME	"Napoleón"
FRENCH_LEADERF_NAME	"María Antonieta"
FRENCH_COUNTRY_NAME	"Francia"
FRENCH_SINGULAR	"Francés"
FRENCH_PLURAL	"Franceses"
FRENCH_CITY_1	"París"
FRENCH_CITY_2	"Toulouse"
FRENCH_CITY_3	"Estrasburgo"
FRENCH_CITY_4	"Rennes"
FRENCH_CITY_5	"Tours"
FRENCH_CITY_6	"Ruán"
FRENCH_CITY_7	"Cannes"
FRENCH_CITY_8	"Niza"
FRENCH_CITY_9	"Burdeos"
FRENCH_CITY_10	"Lille"
FRENCH_CITY_11	"Dijon"
FRENCH_CITY_12	"Marsella"
FRENCH_CITY_13	"Versalles"
FRENCH_CITY_14	"Faverges"
FRENCH_CITY_15	"Chartres"
FRENCH_CITY_16	"Aviñón"
FRENCH_CITY_17	"Giverny"
FRENCH_CITY_18	"St.Tropez"
FRENCH_CITY_19	"Vernon"
FRENCH_CITY_20	"Pauillac"
FRENCH_CITY_21	"Bourges"
FRENCH_CITY_22	"Lorient"
FRENCH_CITY_23	"Le Mans"
FRENCH_CITY_24	"Saint-Etienne"
FRENCH_CITY_25	"Vitrolles"
FRENCH_CITY_26	"Orleans"
FRENCH_CITY_27	"Evian"
FRENCH_CITY_28	"Chantilly"
FRENCH_CITY_29	"Arbois"
FRENCH_CITY_30	"Montreuil"
	
	
JAPANESE	"Japoneses"
	
JAPANESE_LEADERM_NAME	"Minamoto"
JAPANESE_LEADERF_NAME	"Shikibu Murasaki"
JAPANESE_COUNTRY_NAME	"Japón"
JAPANESE_SINGULAR	"Japonés"
JAPANESE_PLURAL	"Japoneses"
JAPANESE_CITY_1	"Kyoto"
JAPANESE_CITY_2	"Osaka"
JAPANESE_CITY_3	"Satsuma"
JAPANESE_CITY_4	"Edo"
JAPANESE_CITY_5	"Nagoya"
JAPANESE_CITY_6	"Yokohama"
JAPANESE_CITY_7	"Matsuyama"
JAPANESE_CITY_8	"Odawara"
JAPANESE_CITY_9	"Hiroshima"
JAPANESE_CITY_10	"Kimobetsu"
JAPANESE_CITY_11	"Gamagori"
JAPANESE_CITY_12	"Sapporo"
JAPANESE_CITY_13	"Fukushima"
JAPANESE_CITY_14	"Kagoshima"
JAPANESE_CITY_15	"Nikko"
JAPANESE_CITY_16	"Okazaki"
JAPANESE_CITY_17	"Chichibu"
JAPANESE_CITY_18	"Tsukaba"
JAPANESE_CITY_19	"Nagano"
JAPANESE_CITY_20	"Miyoshi"
JAPANESE_CITY_21	"Wakamatsu"
JAPANESE_CITY_22	"Sendai"
JAPANESE_CITY_23	"Hirakata"
JAPANESE_CITY_24	"Toyohashi"
JAPANESE_CITY_25	"Kobe"
JAPANESE_CITY_26	"Kawasaki"
JAPANESE_CITY_27	"Mishima"
JAPANESE_CITY_28	"Fukuoka"
JAPANESE_CITY_29	"Nagasaki"
JAPANESE_CITY_30	"Fujinomiya"
	
	
CHINESE	"Chinos"
	
CHINESE_LEADERM_NAME	"Mao Tse-Tung "
CHINESE_LEADERF_NAME	"Wu Zhao"
CHINESE_COUNTRY_NAME	"China"
CHINESE_SINGULAR	"Chino"
CHINESE_PLURAL	"Chinos"
CHINESE_CITY_1	"Pekín"
CHINESE_CITY_2	"Shanghai"
CHINESE_CITY_3	"Xiangtan"
CHINESE_CITY_4	"Hong Kong"
CHINESE_CITY_5	"Canton"
CHINESE_CITY_6	"Tsingtao"
CHINESE_CITY_7	"Chengdu"
CHINESE_CITY_8	"Haicheng"
CHINESE_CITY_9	"Baoding"
CHINESE_CITY_10	"Kunming"
CHINESE_CITY_11	"Nanhai"
CHINESE_CITY_12	"Shenzhen"
CHINESE_CITY_13	"Shantung"
CHINESE_CITY_14	"Zhenjiang"
CHINESE_CITY_15	"Fuyang"
CHINESE_CITY_16	"Shenyang"
CHINESE_CITY_17	"Zibo"
CHINESE_CITY_18	"Nantong"
CHINESE_CITY_19	"Chongqing"
CHINESE_CITY_20	"Xiamen"
CHINESE_CITY_21	"Panjin"
CHINESE_CITY_22	"Jiangyin"
CHINESE_CITY_23	"Llasa"
CHINESE_CITY_24	"Yantai"
CHINESE_CITY_25	"Shaoxing"
CHINESE_CITY_26	"Macao"
CHINESE_CITY_27	"Wuhan"
CHINESE_CITY_28	"Jinan"
CHINESE_CITY_29	"Nanking"
CHINESE_CITY_30	"Changzhou"
	
	
RUSSIAN	"Rusos"
	
RUSSIAN_LEADERM_NAME	"Iván, el Terrible"
RUSSIAN_LEADERF_NAME	"Catalina, la Grande"
RUSSIAN_COUNTRY_NAME	"Rusia"
RUSSIAN_SINGULAR	"Ruso"
RUSSIAN_PLURAL	"Rusos"
RUSSIAN_CITY_1	"Moscú"
RUSSIAN_CITY_2	"Kiev"
RUSSIAN_CITY_3	"S.Petersburgo"
RUSSIAN_CITY_4	"Sevastopol"
RUSSIAN_CITY_5	"Smolensk"
RUSSIAN_CITY_6	"Minsk"
RUSSIAN_CITY_7	"Novosibirsk"
RUSSIAN_CITY_8	"Astrakhan"
RUSSIAN_CITY_9	"Saratov"
RUSSIAN_CITY_10	"Novgorod"
RUSSIAN_CITY_11	"Tblisi"
RUSSIAN_CITY_12	"Ekaterinburg"
RUSSIAN_CITY_13	"Samara"
RUSSIAN_CITY_14	"Kursk"
RUSSIAN_CITY_15	"Vladivostok"
RUSSIAN_CITY_16	"Odessa"
RUSSIAN_CITY_17	"Kazan"
RUSSIAN_CITY_18	"Chelyabinsk"
RUSSIAN_CITY_19	"Bryansk"
RUSSIAN_CITY_20	"Tyumen"
RUSSIAN_CITY_21	"Tomsk"
RUSSIAN_CITY_22	"Barnaul"
RUSSIAN_CITY_23	"Tver"
RUSSIAN_CITY_24	"Irkutsk"
RUSSIAN_CITY_25	"Akademgorodok"
RUSSIAN_CITY_26	"Khabarovsk"
RUSSIAN_CITY_27	"Magnitogorsk"
RUSSIAN_CITY_28	"Taganrog"
RUSSIAN_CITY_29	"Kalingrad"
RUSSIAN_CITY_30	"Omsk"
	
	
SPANISH	"Españoles"
	
SPANISH_LEADERM_NAME	"Fernando"
SPANISH_LEADERF_NAME	"Isabel"
SPANISH_COUNTRY_NAME	"España"
SPANISH_SINGULAR	"Español"
SPANISH_PLURAL	"Españoles"
SPANISH_CITY_1	"Madrid"
SPANISH_CITY_2	"Barcelona"
SPANISH_CITY_3	"Granada"
SPANISH_CITY_4	"Sevilla"
SPANISH_CITY_5	"Toledo"
SPANISH_CITY_6	"León"
SPANISH_CITY_7	"Córdoba"
SPANISH_CITY_8	"Ibiza"
SPANISH_CITY_9	"Pamplona"
SPANISH_CITY_10	"Salamanca"
SPANISH_CITY_11	"Menorca"
SPANISH_CITY_12	"Igualada"
SPANISH_CITY_13	"Cartagena"
SPANISH_CITY_14	"San Roque"
SPANISH_CITY_15	"Las Matas"
SPANISH_CITY_16	"Mallorca"
SPANISH_CITY_17	"Zaragoza"
SPANISH_CITY_18	"Alicante"
SPANISH_CITY_19	"Bilbao"
SPANISH_CITY_20	"Mojácar"
SPANISH_CITY_21	"Pontevedra"
SPANISH_CITY_22	"Montellano"
SPANISH_CITY_23	"Pasajes"
SPANISH_CITY_24	"El Campello"
SPANISH_CITY_25	"Villaviciosa"
SPANISH_CITY_26	"Málaga"
SPANISH_CITY_27	"Cartagena"
SPANISH_CITY_28	"Montefrío"
SPANISH_CITY_29	"Ávila"
SPANISH_CITY_30	"Segovia"
	
	
PORTUGUESE	"Portugueses"
	
PORTUGUESE_LEADERM_NAME	"Vasco de Gama"
PORTUGUESE_LEADERF_NAME	"María II"
PORTUGUESE_COUNTRY_NAME	"Portugal"
PORTUGUESE_SINGULAR	"Portugués"
PORTUGUESE_PLURAL	"Portugueses"
PORTUGUESE_CITY_1	"Lisboa"
PORTUGUESE_CITY_2	"Oporto"
PORTUGUESE_CITY_3	"Lagos"
PORTUGUESE_CITY_4	"Portalegre"
PORTUGUESE_CITY_5	"Pico"
PORTUGUESE_CITY_6	"Funchal"
PORTUGUESE_CITY_7	"Portalegre"
PORTUGUESE_CITY_8	"Coimbra"
PORTUGUESE_CITY_9	"Quarteira"
PORTUGUESE_CITY_10	"Guarda"
PORTUGUESE_CITY_11	"Montijo"
PORTUGUESE_CITY_12	"Terceira"
PORTUGUESE_CITY_13	"Estoril"
PORTUGUESE_CITY_14	"Covilha"
PORTUGUESE_CITY_15	"Aveiro"
PORTUGUESE_CITY_16	"Oeiras"
PORTUGUESE_CITY_17	"Cascais"
PORTUGUESE_CITY_18	"Soajo"
PORTUGUESE_CITY_19	"Ponta Delgada"
PORTUGUESE_CITY_20	"Santa Maria"
PORTUGUESE_CITY_21	"Santarem"
PORTUGUESE_CITY_22	"Famalicao"
PORTUGUESE_CITY_23	"Tavira"
PORTUGUESE_CITY_24	"Guimaraes"
PORTUGUESE_CITY_25	"Santa Miguel"
PORTUGUESE_CITY_26	"Cedros"
PORTUGUESE_CITY_27	"Fulores"
PORTUGUESE_CITY_28	"Albufeira"
PORTUGUESE_CITY_29	"Loule"
PORTUGUESE_CITY_30	"Alcoutim"

	
DUTCH	"Holandeses"
	
DUTCH_LEADERM_NAME	"Guillermo I"
DUTCH_LEADERF_NAME	"Guillermina"
DUTCH_COUNTRY_NAME	"Holanda"
DUTCH_SINGULAR	"Holandés"
DUTCH_PLURAL	"Holandeses"
DUTCH_CITY_1	"Amsterdam"
DUTCH_CITY_2	"La Haya"
DUTCH_CITY_3	"Arnhem"
DUTCH_CITY_4	"Middleburg"
DUTCH_CITY_5	"Leeuwarden"
DUTCH_CITY_6	"Assen"
DUTCH_CITY_7	"Groningen"
DUTCH_CITY_8	"Utrecht"
DUTCH_CITY_9	"Hertogenbosch"
DUTCH_CITY_10	"Maastricht"
DUTCH_CITY_11	"Vlaardingen"
DUTCH_CITY_12	"Eindhoven"
DUTCH_CITY_13	"Dordrecht"
DUTCH_CITY_14	"Zeist"
DUTCH_CITY_15	"Apeldoorn"
DUTCH_CITY_16	"Rotterdam"
DUTCH_CITY_17	"Den Helder"
DUTCH_CITY_18	"Leiderdorp"
DUTCH_CITY_19	"Hoofddorp"
DUTCH_CITY_20	"Zannstad"
DUTCH_CITY_21	"Vlissingen"
DUTCH_CITY_22	"Gouda"
DUTCH_CITY_23	"Leiden"
DUTCH_CITY_24	"Heerenveen"
DUTCH_CITY_25	"Venlo"
DUTCH_CITY_26	"Sittard"
DUTCH_CITY_27	"Ede"
DUTCH_CITY_28	"Hoorn"
DUTCH_CITY_29	"Breukelen"
DUTCH_CITY_30	"Haarlem"
	
	
VIKING	"Vikingos"
	
VIKING_LEADERM_NAME	"Rey Canuto"
VIKING_LEADERF_NAME	"Gunnhilda"
VIKING_COUNTRY_NAME	"Imperio Vikingo"
VIKING_SINGULAR	"Vikingo"
VIKING_PLURAL	"Vikingos"
VIKING_CITY_1	"Trondheim"
VIKING_CITY_2	"Hladir"
VIKING_CITY_3	"Kaupang"
VIKING_CITY_4	"Uppsala"
VIKING_CITY_5	"Roskilde"
VIKING_CITY_6	"Viborg"
VIKING_CITY_7	"Goteborg"
VIKING_CITY_8	"Odense"
VIKING_CITY_9	"Bergen"
VIKING_CITY_10	"Linkoping"
VIKING_CITY_11	"Jarlshof"
VIKING_CITY_12	"Bornholm"
VIKING_CITY_13	"Alesund"
VIKING_CITY_14	"Koping"
VIKING_CITY_15	"Tampere"
VIKING_CITY_16	"Stavanger"
VIKING_CITY_17	"Aalborg"
VIKING_CITY_18	"Copenhague"
VIKING_CITY_19	"Tromso"
VIKING_CITY_20	"Harstad"
VIKING_CITY_21	"Hammerfest"
VIKING_CITY_22	"Ostersund"
VIKING_CITY_23	"Stavanger"
VIKING_CITY_24	"Sundsvall"
VIKING_CITY_25	"Karlstad"
VIKING_CITY_26	"Groenbjerg"
VIKING_CITY_27	"Nykoping"
VIKING_CITY_28	"Brumunddal"
VIKING_CITY_29	"Helsingborg"
VIKING_CITY_30	"Ringerike"
	
	
ROMAN	"Romanos"
	
ROMAN_LEADERM_NAME	"Julio César"
ROMAN_LEADERF_NAME	"Livia Drusilla"
ROMAN_COUNTRY_NAME	"Roma"
ROMAN_SINGULAR	"Romano"
ROMAN_PLURAL	"Romanos"
ROMAN_CITY_1	"Roma"
ROMAN_CITY_2	"Pompeya"
ROMAN_CITY_3	"Antium"
ROMAN_CITY_4	"Virconium"
ROMAN_CITY_5	"Caesarea"
ROMAN_CITY_6	"Augustodunum"
ROMAN_CITY_7	"Neapolis"
ROMAN_CITY_8	"Agrippina"
ROMAN_CITY_9	"Palmyra"
ROMAN_CITY_10	"Londinium"
ROMAN_CITY_11	"Eburacum"
ROMAN_CITY_12	"Tarentum"
ROMAN_CITY_13	"Brundisium"
ROMAN_CITY_14	"Byzantium"
ROMAN_CITY_15	"Aquila"
ROMAN_CITY_16	"Sirmium"
ROMAN_CITY_17	"Hispalis"
ROMAN_CITY_18	"Syracuse"
ROMAN_CITY_19	"Jerusalem"
ROMAN_CITY_20	"Florentia"
ROMAN_CITY_21	"Banonia"
ROMAN_CITY_22	"Nicomedia"
ROMAN_CITY_23	"Vindonissa"
ROMAN_CITY_24	"Argentoratum"
ROMAN_CITY_25	"Nemausus"
ROMAN_CITY_26	"Siscia"
ROMAN_CITY_27	"Asturica"
ROMAN_CITY_28	"Viminiacium"
ROMAN_CITY_29	"Agrigentum"
ROMAN_CITY_30	"Genua"
	
	
EGYPTIAN	"Egipcios"
	
EGYPTIAN_LEADERM_NAME	"Ramsés"
EGYPTIAN_LEADERF_NAME	"Hatshepsut"
EGYPTIAN_COUNTRY_NAME	"Egipto"
EGYPTIAN_SINGULAR	"Egipcio"
EGYPTIAN_PLURAL	"Egipcios"
EGYPTIAN_CITY_1	"El Cairo"
EGYPTIAN_CITY_2	"Tebas"
EGYPTIAN_CITY_3	"Alejandría"
EGYPTIAN_CITY_4	"Memfis"
EGYPTIAN_CITY_5	"Giza"
EGYPTIAN_CITY_6	"Elefantina"
EGYPTIAN_CITY_7	"Oryx"
EGYPTIAN_CITY_8	"Sinaí"
EGYPTIAN_CITY_9	"Busiris"
EGYPTIAN_CITY_10	"Athribis"
EGYPTIAN_CITY_11	"Tanis"
EGYPTIAN_CITY_12	"Bubastis"
EGYPTIAN_CITY_13	"Sebennytos"
EGYPTIAN_CITY_14	"Hermópolis"
EGYPTIAN_CITY_15	"Meydum"
EGYPTIAN_CITY_16	"Rosetta"
EGYPTIAN_CITY_17	"Lisht"
EGYPTIAN_CITY_18	"Naucratis"
EGYPTIAN_CITY_19	"Hawara"
EGYPTIAN_CITY_20	"Abusir"
EGYPTIAN_CITY_21	"Edfu"
EGYPTIAN_CITY_22	"Buto"
EGYPTIAN_CITY_23	"Filé"
EGYPTIAN_CITY_24	"Esna"
EGYPTIAN_CITY_25	"Dendera"
EGYPTIAN_CITY_26	"Naqada"
EGYPTIAN_CITY_27	"Abydos"
EGYPTIAN_CITY_28	"Saqqara"
EGYPTIAN_CITY_29	"Coptos"
EGYPTIAN_CITY_30	"Gebelein"
	
	
PERSIAN	"Persas"
	
PERSIAN_LEADERM_NAME	"Ciro, el Grande"
PERSIAN_LEADERF_NAME	"Scheherazade"
PERSIAN_COUNTRY_NAME	"Persia"
PERSIAN_SINGULAR	"Persa"
PERSIAN_PLURAL	"Persas"
PERSIAN_CITY_1	"Hircania"
PERSIAN_CITY_2	"Margiana"
PERSIAN_CITY_3	"Babilonia"
PERSIAN_CITY_4	"Pérsico"
PERSIAN_CITY_5	"Dahae"
PERSIAN_CITY_6	"Parthia"
PERSIAN_CITY_7	"Ashur"
PERSIAN_CITY_8	"Bactriana"
PERSIAN_CITY_9	"Persépolis"
PERSIAN_CITY_10	"Palestina"
PERSIAN_CITY_11	"Maracanda"
PERSIAN_CITY_12	"Pasargadas"
PERSIAN_CITY_13	"Jarmy"
PERSIAN_CITY_14	"Cunaxa"
PERSIAN_CITY_15	"Ecbatana"
PERSIAN_CITY_16	"Antioquía"
PERSIAN_CITY_17	"Nínive"
PERSIAN_CITY_18	"Amón"
PERSIAN_CITY_19	"Sardis"
PERSIAN_CITY_20	"Drangiana"
PERSIAN_CITY_21	"Archosia"
PERSIAN_CITY_22	"Behistun"
PERSIAN_CITY_23	"Susa"
PERSIAN_CITY_24	"Harran"
PERSIAN_CITY_25	"Siria"
PERSIAN_CITY_26	"Asiria"
PERSIAN_CITY_27	"Elam"
PERSIAN_CITY_28	"Carmania"
PERSIAN_CITY_29	"Salamina"
PERSIAN_CITY_30	"Aria"
	
	
TURKISH	"Turcos"
	
TURKISH_LEADERM_NAME	"Osmán I"
TURKISH_LEADERF_NAME	"Teófilo"
TURKISH_COUNTRY_NAME	"Turquía"
TURKISH_SINGULAR	"Turco"
TURKISH_PLURAL	"Turcos"
TURKISH_CITY_1	"Ankara"
TURKISH_CITY_2	"Estambul"
TURKISH_CITY_3	"Bursa"
TURKISH_CITY_4	"Konya"
TURKISH_CITY_5	"Samsun"
TURKISH_CITY_6	"Gaziantep"
TURKISH_CITY_7	"Diyarbakir"
TURKISH_CITY_8	"Esmirna"
TURKISH_CITY_9	"Kayseri"
TURKISH_CITY_10	"Malatya"
TURKISH_CITY_11	"Marsin"
TURKISH_CITY_12	"Antalya"
TURKISH_CITY_13	"Zonguldak"
TURKISH_CITY_14	"Denizli"
TURKISH_CITY_15	"Oidu"
TURKISH_CITY_16	"Mugla"
TURKISH_CITY_17	"Eskisehir"
TURKISH_CITY_18	"Inebolu"
TURKISH_CITY_19	"Sinop"
TURKISH_CITY_20	"Adana"
TURKISH_CITY_21	"Tarso"
TURKISH_CITY_22	"Artuin"
TURKISH_CITY_23	"Bodrum"
TURKISH_CITY_24	"Eregli"
TURKISH_CITY_25	"Silifke"
TURKISH_CITY_26	"Sivas"
TURKISH_CITY_27	"Amasya"
TURKISH_CITY_28	"Mármara"
TURKISH_CITY_29	"Kastamonu"
TURKISH_CITY_30	"Afyon"
	
	
PHOENICIAN	"Fenicios"
	
PHOENICIAN_LEADERM_NAME	"Hiram"
PHOENICIAN_LEADERF_NAME	"Atalía"
PHOENICIAN_COUNTRY_NAME	"Fenicia"
PHOENICIAN_SINGULAR	"Fenicio"
PHOENICIAN_PLURAL	"Fenicios"
PHOENICIAN_CITY_1	"Baalbek"
PHOENICIAN_CITY_2	"Berytus"
PHOENICIAN_CITY_3	"Biblos"
PHOENICIAN_CITY_4	"Aradus"
PHOENICIAN_CITY_5	"Cartago"
PHOENICIAN_CITY_6	"Sidón"
PHOENICIAN_CITY_7	"Tiro"
PHOENICIAN_CITY_8	"Zareptha"
PHOENICIAN_CITY_9	"Sexi"
PHOENICIAN_CITY_10	"Útica"
PHOENICIAN_CITY_11	"Hadrumetum"
PHOENICIAN_CITY_12	"Tipasa"
PHOENICIAN_CITY_13	"Siga"
PHOENICIAN_CITY_14	"Nora"
PHOENICIAN_CITY_15	"Sulcis"
PHOENICIAN_CITY_16	"Tharros"
PHOENICIAN_CITY_17	"Almuñécar"
PHOENICIAN_CITY_18	"Abdera"
PHOENICIAN_CITY_19	"Baria"
PHOENICIAN_CITY_20	"Carmona"
PHOENICIAN_CITY_21	"Malaca"
PHOENICIAN_CITY_22	"Gadir"
PHOENICIAN_CITY_23	"Arvad"
PHOENICIAN_CITY_24	"Eivissa"
PHOENICIAN_CITY_25	"Samal"
PHOENICIAN_CITY_26	"Karatepe"
PHOENICIAN_CITY_27	"Motya"
PHOENICIAN_CITY_28	"Joppe"
PHOENICIAN_CITY_29	"Rachgoun"
PHOENICIAN_CITY_30	"Gades"
	
	
WELSH	"Galeses"
	
WELSH_LEADERM_NAME	"Owain Glyndwr"
WELSH_LEADERF_NAME	"Rhiannon"
WELSH_COUNTRY_NAME	"Gales"
WELSH_SINGULAR	"Galés"
WELSH_PLURAL	"Galeses"
WELSH_CITY_1	"Cardiff"
WELSH_CITY_2	"Swansea"
WELSH_CITY_3	"Pentraeth"
WELSH_CITY_4	"Brecon"
WELSH_CITY_5	"Caerphilly"
WELSH_CITY_6	"Pontypridd"
WELSH_CITY_7	"Narberth"
WELSH_CITY_8	"Llandow"
WELSH_CITY_9	"Cwmbran"
WELSH_CITY_10	"Pembroke"
WELSH_CITY_11	"Cardigan"
WELSH_CITY_12	"Llandarcy"
WELSH_CITY_13	"Builth Wells"
WELSH_CITY_14	"Beddgelert"
WELSH_CITY_15	"Abertillery"
WELSH_CITY_16	"Porth"
WELSH_CITY_17	"Lampeter"
WELSH_CITY_18	"Welshpool"
WELSH_CITY_19	"Llangollen"
WELSH_CITY_20	"Ebbw Vale"
WELSH_CITY_21	"Chepstow"
WELSH_CITY_22	"Llandybie"
WELSH_CITY_23	"Denbigh"
WELSH_CITY_24	"Pembrey"
WELSH_CITY_25	"Tresaith"
WELSH_CITY_26	"Taffs Well"
WELSH_CITY_27	"Penarth"
WELSH_CITY_28	"Caernarfon"
WELSH_CITY_29	"Llandudno"
WELSH_CITY_30	"Gwaelod"
	
	
CUBAN	"Cubanos"
	
CUBAN_LEADERM_NAME	"José Martí"
CUBAN_LEADERF_NAME	"Vilma Espin"
CUBAN_COUNTRY_NAME	"Cuba"
CUBAN_SINGULAR	"Cubano"
CUBAN_PLURAL	"Cubanos"
CUBAN_CITY_1	"La Habana"
CUBAN_CITY_2	"Cardenas"
CUBAN_CITY_3	"Cabanas"
CUBAN_CITY_4	"Matanzas"
CUBAN_CITY_5	"Pinar del Río"
CUBAN_CITY_6	"Guantanamo"
CUBAN_CITY_7	"Moa"
CUBAN_CITY_8	"Nuevitas"
CUBAN_CITY_9	"Esmeralda"
CUBAN_CITY_10	"La Isabela"
CUBAN_CITY_11	"Gibara"
CUBAN_CITY_12	"Los Arroyos"
CUBAN_CITY_13	"San Cristóbal"
CUBAN_CITY_14	"Santa Clara"
CUBAN_CITY_15	"Ciego de Ávila"
CUBAN_CITY_16	"Bayamo"
CUBAN_CITY_17	"La Esperanza"
CUBAN_CITY_18	"Tunas de Zaza"
CUBAN_CITY_19	"Niquero"
CUBAN_CITY_20	"Holguin"
CUBAN_CITY_21	"Nueva Gerona"
CUBAN_CITY_22	"Antilla"
CUBAN_CITY_23	"Baracoa"
CUBAN_CITY_24	"Cienfuegos"
CUBAN_CITY_25	"Artemisa"
CUBAN_CITY_26	"Guane"
CUBAN_CITY_27	"Santiago"
CUBAN_CITY_28	"Martí"
CUBAN_CITY_29	"Colón"
CUBAN_CITY_30	"Morón"
	
	
ZULU	"Zulúes"
	
ZULU_LEADERM_NAME	"Shaka Zulu"
ZULU_LEADERF_NAME	"Shakala"
ZULU_COUNTRY_NAME	"Zululandia"
ZULU_SINGULAR	"Zulú"
ZULU_PLURAL	"Zulúes"
ZULU_CITY_1	"Ulundi"
ZULU_CITY_2	"Natal"
ZULU_CITY_3	"Isandlwana"
ZULU_CITY_4	"Swazi"
ZULU_CITY_5	"Pedi"
ZULU_CITY_6	"Thembu"
ZULU_CITY_7	"Sotho"
ZULU_CITY_8	"Taung"
ZULU_CITY_9	"Xhosa"
ZULU_CITY_10	"Tlokwa"
ZULU_CITY_11	"Tswana"
ZULU_CITY_12	"Kwena"
ZULU_CITY_13	"Ngwaketse"
ZULU_CITY_14	"Kora"
ZULU_CITY_15	"Nongoma"
ZULU_CITY_16	"Hluhluwe"
ZULU_CITY_17	"Mtubatuba"
ZULU_CITY_18	"Empangeni"
ZULU_CITY_19	"Ingwauuma"
ZULU_CITY_20	"Melmoth"
ZULU_CITY_21	"Mkuke"
ZULU_CITY_22	"Jozini"
ZULU_CITY_23	"Usut"
ZULU_CITY_24	"Maputo"
ZULU_CITY_25	"Mpondo"
ZULU_CITY_26	"Ngome"
ZULU_CITY_27	"Umtata"
ZULU_CITY_28	"Tugela"
ZULU_CITY_29	"Ibabanago"
ZULU_CITY_30	"Isipezi"
	
	
HEBREW	"Hebreos"
	
HEBREW_LEADERM_NAME	"David"
HEBREW_LEADERF_NAME	"Golda Meir"
HEBREW_COUNTRY_NAME	"Israel"
HEBREW_SINGULAR	"Hebreo"
HEBREW_PLURAL	"Hebreos"
HEBREW_CITY_1	"Jerusalén"
HEBREW_CITY_2	"Hebrón"
HEBREW_CITY_3	"Jericó"
HEBREW_CITY_4	"Tel Aviv"
HEBREW_CITY_5	"Jaffa"
HEBREW_CITY_6	"Ashdod"
HEBREW_CITY_7	"Nazaret"
HEBREW_CITY_8	"Belén"
HEBREW_CITY_9	"Tiberíades"
HEBREW_CITY_10	"Haifa"
HEBREW_CITY_11	"Gaza"
HEBREW_CITY_12	"Beersheva"
HEBREW_CITY_13	"Netanya"
HEBREW_CITY_14	"Bnei Brak"
HEBREW_CITY_15	"Tiro"
HEBREW_CITY_16	"Ashkelon"
HEBREW_CITY_17	"Ramat Gan"
HEBREW_CITY_18	"Kidron"
HEBREW_CITY_19	"Ra'anana"
HEBREW_CITY_20	"Kfar-Saba"
HEBREW_CITY_21	"Rishon-Lezion"
HEBREW_CITY_22	"Dan"
HEBREW_CITY_23	"Rehovot"
HEBREW_CITY_24	"Ramallah"
HEBREW_CITY_25	"Yavne"
HEBREW_CITY_26	"Zoar"
HEBREW_CITY_27	"Edrei"
HEBREW_CITY_28	"Eilat"
HEBREW_CITY_29	"Galilea"
HEBREW_CITY_30	"Holon"
	
	
ASSYRIAN	"Asirios"
	
ASSYRIAN_LEADERM_NAME "Tiglath-Pileser III"
ASSYRIAN_LEADERF_NAME "Samu-Ramat"
ASSYRIAN_COUNTRY_NAME	"Asiria"
ASSYRIAN_SINGULAR	"Asirio"
ASSYRIAN_PLURAL	"Asirios"
ASSYRIAN_CITY_1	"Nínive"
ASSYRIAN_CITY_2	"Ur"
ASSYRIAN_CITY_3	"Assur"
ASSYRIAN_CITY_4	"Nippur"
ASSYRIAN_CITY_5	"Uruk"
ASSYRIAN_CITY_6	"Kakzu"
ASSYRIAN_CITY_7	"Gasur"
ASSYRIAN_CITY_8	"Arrapha"
ASSYRIAN_CITY_9	"Calah"
ASSYRIAN_CITY_10	"Barsippa"
ASSYRIAN_CITY_11	"Nimit Ishtar"
ASSYRIAN_CITY_12	"Sippar"
ASSYRIAN_CITY_13	"Ninua"
ASSYRIAN_CITY_14	"Shibaniba"
ASSYRIAN_CITY_15	"Dur Sharrukin"
ASSYRIAN_CITY_16	"Balata"
ASSYRIAN_CITY_17	"Tarbisu"
ASSYRIAN_CITY_18	"Simmurrum"
ASSYRIAN_CITY_19	"Asari"
ASSYRIAN_CITY_20	"Imbur-Bel"
ASSYRIAN_CITY_21	"Tell Rimah"
ASSYRIAN_CITY_22	"Arballu"
ASSYRIAN_CITY_23	"Kar-Tukulti"
ASSYRIAN_CITY_24	"Nimurta"
ASSYRIAN_CITY_25	"Hatra"
ASSYRIAN_CITY_26	"Rania"
ASSYRIAN_CITY_27	"Jerwan"
ASSYRIAN_CITY_28	"Marad"
ASSYRIAN_CITY_29	"Kutha"
ASSYRIAN_CITY_30	"Neribtum"
	
	
INDIAN	"Indios"
	
INDIAN_LEADERM_NAME	"Mohandas Gandhi"
INDIAN_LEADERF_NAME	"Indira Gandhi"
INDIAN_COUNTRY_NAME	"India"
INDIAN_SINGULAR	"Indio"
INDIAN_PLURAL	"Indios"
INDIAN_CITY_1	"Delhi"
INDIAN_CITY_2	"Bombay"
INDIAN_CITY_3	"Bangalore"
INDIAN_CITY_4	"Calcuta"
INDIAN_CITY_5	"Darjeeling"
INDIAN_CITY_6	"Guntur"
INDIAN_CITY_7	"Srinagar"
INDIAN_CITY_8	"Manali"
INDIAN_CITY_9	"Panchkula"
INDIAN_CITY_10	"Tiruppur"
INDIAN_CITY_11	"Nagpur"
INDIAN_CITY_12	"Almora"
INDIAN_CITY_13	"Kootanad"
INDIAN_CITY_14	"Bhubaneswar"
INDIAN_CITY_15	"Jaipur"
INDIAN_CITY_16	"Surat"
INDIAN_CITY_17	"Madura"
INDIAN_CITY_18	"Jalandhar"
INDIAN_CITY_19	"Rajkot"
INDIAN_CITY_20	"Moradabad"
INDIAN_CITY_21	"Bharuch"
INDIAN_CITY_22	"Udupi"
INDIAN_CITY_23	"Ghaziabad"
INDIAN_CITY_24	"Jodhpur"
INDIAN_CITY_25	"Amritsar"
INDIAN_CITY_26	"Nashik"
INDIAN_CITY_27	"Ahmedabad"
INDIAN_CITY_28	"Pilani"
INDIAN_CITY_29	"Kanpur"
INDIAN_CITY_30	"Vellore"
	
	
THAI	"Tailandeses"
	
THAI_LEADERM_NAME	"Yot Fa"
THAI_LEADERF_NAME	"Son Klin"
THAI_COUNTRY_NAME	"Tailandia"
THAI_SINGULAR	"Tailandés"
THAI_PLURAL	"Tailandeses"
THAI_CITY_1	"Bangkok"
THAI_CITY_2	"Chiang Mai"
THAI_CITY_3	"Hat Yai"
THAI_CITY_4	"Lampang"
THAI_CITY_5	"Muang Boran"
THAI_CITY_6	"Ayutthaya"
THAI_CITY_7	"Chonburi"
THAI_CITY_8	"Rayong"
THAI_CITY_9	"Ubon Ratchathani"
THAI_CITY_10	"Korat"
THAI_CITY_11	"Hua Hin"
THAI_CITY_12	"Chiang Rai"
THAI_CITY_13	"Nonthaburi"
THAI_CITY_14	"Pathumthani"
THAI_CITY_15	"Khon Kaen"
THAI_CITY_16	"Pattaya"
THAI_CITY_17	"Samutprakarn"
THAI_CITY_18	"Nakhon Ratchasima"
THAI_CITY_19	"Mae Hong Son"
THAI_CITY_20	"Chanthaburi"
THAI_CITY_21	"Nakhon Pathom"
THAI_CITY_22	"Tak"
THAI_CITY_23	"Koh Phangan"
THAI_CITY_24	"Koh Phi Phi"
THAI_CITY_25	"Koh Samui"
THAI_CITY_26	"Koh Tao"
THAI_CITY_27	"Stick"
THAI_CITY_28	"Siam"
THAI_CITY_29	"Phuket"
THAI_CITY_30	"Klongkum"
	
	
POLYNESIAN	"Polinesios"
	
POLYNESIAN_LEADERM_NAME	"Kamehameha"
POLYNESIAN_LEADERF_NAME	"Liliuokalani"
POLYNESIAN_COUNTRY_NAME	"Polinesia"
POLYNESIAN_SINGULAR	"Polinesio"
POLYNESIAN_PLURAL	"Polinesios"
POLYNESIAN_CITY_1	"Haraiki"
POLYNESIAN_CITY_2	"Tikei"
POLYNESIAN_CITY_3	"Pukapuka"
POLYNESIAN_CITY_4	"Manihi"
POLYNESIAN_CITY_5	"Hiva"
POLYNESIAN_CITY_6	"Fata Huka"
POLYNESIAN_CITY_7	"Ua Pou"
POLYNESIAN_CITY_8	"Tonga"
POLYNESIAN_CITY_9	"Ahe"
POLYNESIAN_CITY_10	"Niau"
POLYNESIAN_CITY_11	"Akiaki"
POLYNESIAN_CITY_12	"Tatakoko"
POLYNESIAN_CITY_13	"Hatutu"
POLYNESIAN_CITY_14	"Aratika"
POLYNESIAN_CITY_15	"Hao"
POLYNESIAN_CITY_16	"Tahuata"
POLYNESIAN_CITY_17	"Mataiva"
POLYNESIAN_CITY_18	"Reao"
POLYNESIAN_CITY_19	"Tematagi"
POLYNESIAN_CITY_20	"Marutea"
POLYNESIAN_CITY_21	"Taenga"
POLYNESIAN_CITY_22	"Nuka Hiua"
POLYNESIAN_CITY_23	"Motane"
POLYNESIAN_CITY_24	"Hereheretua"
POLYNESIAN_CITY_25	"Tokelau"
POLYNESIAN_CITY_26	"Hikueru"
POLYNESIAN_CITY_27	"Rekareka"
POLYNESIAN_CITY_28	"Tureia"
POLYNESIAN_CITY_29	"Fangataufa"
POLYNESIAN_CITY_30	"Manuhangi"
	
	
INDONESIAN	"Indonesios"
	
INDONESIAN_LEADERM_NAME	"Airlangga"
INDONESIAN_LEADERF_NAME	"Indoiana"
INDONESIAN_COUNTRY_NAME	"Indonesia"
INDONESIAN_SINGULAR	"Indonesio"
INDONESIAN_PLURAL	"Indonesios"
INDONESIAN_CITY_1	"Jakarta"
INDONESIAN_CITY_2	"Malang"
INDONESIAN_CITY_3	"Bali"
INDONESIAN_CITY_4	"Sumatra"
INDONESIAN_CITY_5	"Yogyakarta"
INDONESIAN_CITY_6	"Java"
INDONESIAN_CITY_7	"Denpasar"
INDONESIAN_CITY_8	"Kuta"
INDONESIAN_CITY_9	"Semarang"
INDONESIAN_CITY_10	"Kendari"
INDONESIAN_CITY_11	"Medan"
INDONESIAN_CITY_12	"Bandung"
INDONESIAN_CITY_13	"Surabaya"
INDONESIAN_CITY_14	"Tangerang"
INDONESIAN_CITY_15	"Batam"
INDONESIAN_CITY_16	"Kudus"
INDONESIAN_CITY_17	"Manado"
INDONESIAN_CITY_18	"Solo"
INDONESIAN_CITY_19	"Cirebon"
INDONESIAN_CITY_20	"Banda Aceh"
INDONESIAN_CITY_21	"Pontianak"
INDONESIAN_CITY_22	"Jepara"
INDONESIAN_CITY_23	"Bogor"
INDONESIAN_CITY_24	"Salatiga"
INDONESIAN_CITY_25	"Banyuwangi"
INDONESIAN_CITY_26	"Palembang"
INDONESIAN_CITY_27	"Surakarta"
INDONESIAN_CITY_28	"Pangandaran"
INDONESIAN_CITY_29	"Ujungpandang"
INDONESIAN_CITY_30	"Lombok"
	
	
JAMAICA "Polonia"

JAMAICAN_LEADERM_NAME "Lech Walesa"
JAMAICAN_LEADERF_NAME "La reina Jadwiga"
JAMAICAN_COUNTRY_NAME "Polonia"
JAMAICAN_SINGULAR "Polaco"
JAMAICAN_PLURAL "Polacos"

JAMAICAN_CITY_1 "Varsovia"
JAMAICAN_CITY_2 "Cracovia"
JAMAICAN_CITY_3 "Gniezno"
JAMAICAN_CITY_4 "Gdansk"
JAMAICAN_CITY_5 "Katowice"
JAMAICAN_CITY_6 "Wroclaw"
JAMAICAN_CITY_7 "Czestochowa"
JAMAICAN_CITY_8 "Gydnia"
JAMAICAN_CITY_9 "Szczecin"
JAMAICAN_CITY_10 "Poznan"
JAMAICAN_CITY_11 "Lódz"
JAMAICAN_CITY_12 "Bydgoszcz"
JAMAICAN_CITY_13 "Radom"
JAMAICAN_CITY_14 "Lublín"
JAMAICAN_CITY_15 "Bialystok"
JAMAICAN_CITY_16 "Ustka"
JAMAICAN_CITY_17 "Kolobrzeg"
JAMAICAN_CITY_18 "Tourn"
JAMAICAN_CITY_19 "Zakopane"
JAMAICAN_CITY_20 "Olsztyn"
JAMAICAN_CITY_21 "Opole"
JAMAICAN_CITY_22 "Kutno"
JAMAICAN_CITY_23 "Slubice"
JAMAICAN_CITY_24 "Wadowice"
JAMAICAN_CITY_25 "Walbrzych"
JAMAICAN_CITY_26 "Zywiec"
JAMAICAN_CITY_27 "Bielsko-Biala"
JAMAICAN_CITY_28 "Wolmomin"
JAMAICAN_CITY_29 "Malbrok"
JAMAICAN_CITY_30 "Rzeszów"

	
	
INCAN	"Incas"
	
INCAN_LEADERM_NAME	"Viracocha"
INCAN_LEADERF_NAME	"Manachocha"
INCAN_COUNTRY_NAME	"Inca"
INCAN_SINGULAR	"Inca"
INCAN_PLURAL	"Incas"
INCAN_CITY_1	"Cuzco"
INCAN_CITY_2	"Machu Picchu"
INCAN_CITY_3	"Pucará"
INCAN_CITY_4	"Chimbote"
INCAN_CITY_5	"Cupisnique"
INCAN_CITY_6	"Paracas"
INCAN_CITY_7	"Huari"
INCAN_CITY_8	"Pachacamac"
INCAN_CITY_9	"Paramonga"
INCAN_CITY_10	"Supe"
INCAN_CITY_11	"Ancón"
INCAN_CITY_12	"Cajamarquilla"
INCAN_CITY_13	"Ocucaje"
INCAN_CITY_14	"Cahauchi"
INCAN_CITY_15	"Arequipa" 
INCAN_CITY_16	"Tihuanaco"
INCAN_CITY_17	"Chiripa"
INCAN_CITY_18	"Ollantaytambo"
INCAN_CITY_19	"Pikillacta"
INCAN_CITY_20	"Lauricocha"
INCAN_CITY_21	"Chavín de Huantar"
INCAN_CITY_22	"Cerro Sechin"
INCAN_CITY_23	"Chanchán"
INCAN_CITY_24	"Moche"
INCAN_CITY_25	"Huamachuco"
INCAN_CITY_26	"Cajamarca"
INCAN_CITY_27	"Lambayeque"
INCAN_CITY_28	"Pacasmayo"
INCAN_CITY_29	"Huaca Prieta"
INCAN_CITY_30	"Pampa de Paijan"
	
	
MAYAN	"Mayas"
	
MAYAN_LEADERM_NAME	"Hunahpu"
MAYAN_LEADERF_NAME	"Xmucane"
MAYAN_COUNTRY_NAME	"Maya"
MAYAN_SINGULAR	"Maya"
MAYAN_PLURAL	"Mayas"
MAYAN_CITY_1	"Copán"
MAYAN_CITY_2	"Chichén Itzá"
MAYAN_CITY_3	"Uxmal"
MAYAN_CITY_4	"Jaina"
MAYAN_CITY_5	"Palenque"
MAYAN_CITY_6	"Uaxactún"
MAYAN_CITY_7	"Yaxchilán"
MAYAN_CITY_8	"Tikal"
MAYAN_CITY_9	"Tonina"
MAYAN_CITY_10	"Toltec"
MAYAN_CITY_11	"Etzna"
MAYAN_CITY_12	"Kabah Labna"
MAYAN_CITY_13	"Xpuhil"
MAYAN_CITY_14	"Calakmul"
MAYAN_CITY_15	"Comalcatco"
MAYAN_CITY_16	"Tenampua"
MAYAN_CITY_17	"Yojoa"
MAYAN_CITY_18	"Yarumal" 
MAYAN_CITY_19	"Zaculeu"
MAYAN_CITY_20	"Seibal"
MAYAN_CITY_21	"Dzibilchaltun"
MAYAN_CITY_22	"Quiriguá"
MAYAN_CITY_23	"Lubaantun"
MAYAN_CITY_24	"Pusilha"
MAYAN_CITY_25	"Chinkultic"
MAYAN_CITY_26	"Lo De Vaca"
MAYAN_CITY_27	"Guápiles"
MAYAN_CITY_28	"Palmar"
MAYAN_CITY_29	"Sayil"
MAYAN_CITY_30	"Las Huacas"
	
CANADIANS	"Canadienses"
	
CANADIANS_LEADERM_NAME	"Pierre Trudeau"
CANADIANS_LEADERF_NAME	"Madeleine de Vercheres"
CANADIANS_COUNTRY_NAME	"Canadá"
CANADIANS_SINGULAR	"Canadiense"
CANADIANS_PLURAL	"Canadienses"
CANADIANS_CITY_1	"Ottawa"
CANADIANS_CITY_2	"Montreal"
CANADIANS_CITY_3	"Edmonton"
CANADIANS_CITY_4	"Calgary"
CANADIANS_CITY_5	"Vancouver"
CANADIANS_CITY_6	"Winnipeg"
CANADIANS_CITY_7	"Regina"
CANADIANS_CITY_8	"Toronto"
CANADIANS_CITY_9	"Whistler"
CANADIANS_CITY_10	"Whitehorse"
CANADIANS_CITY_11	"Banff"
CANADIANS_CITY_12	"Sundre"
CANADIANS_CITY_13	"Halifax"
CANADIANS_CITY_14	"St. John"
CANADIANS_CITY_15	"Victoria"
CANADIANS_CITY_16	"Niágara"
CANADIANS_CITY_17	"Longlac"
CANADIANS_CITY_18	"Cobalt"
CANADIANS_CITY_19	"Brandon"
CANADIANS_CITY_20	"St. Claude"
CANADIANS_CITY_21	"Battleford"
CANADIANS_CITY_22	"Lethbridge"
CANADIANS_CITY_23	"Moosonee"
CANADIANS_CITY_24	"Vermilion"
CANADIANS_CITY_25	"La Ronge"
CANADIANS_CITY_26	"Chesterfield"
CANADIANS_CITY_27	"Tecumseh"
CANADIANS_CITY_28	"Gatineau"
CANADIANS_CITY_29	"Iron River"
CANADIANS_CITY_30	"Head Smashed In"
	
NIGERIAN	"Nigerianos"
	
NIGERIAN_LEADERM_NAME	"Azikiwe"
NIGERIAN_LEADERF_NAME	"Nzinga"
NIGERIAN_COUNTRY_NAME	"Nigeria"
NIGERIAN_SINGULAR	"Nigeriano"
NIGERIAN_PLURAL	"Nigerianos"
NIGERIAN_CITY_1	"Benín"
NIGERIAN_CITY_2	"Ibadan"
NIGERIAN_CITY_3	"Makurdi"
NIGERIAN_CITY_4	"Enugu"
NIGERIAN_CITY_5	"Ogoja"
NIGERIAN_CITY_6	"Oyo"
NIGERIAN_CITY_7	"Kaduna"
NIGERIAN_CITY_8	"Zaria"
NIGERIAN_CITY_9	"Sokoto"
NIGERIAN_CITY_10	"Bauchi"
NIGERIAN_CITY_11	"Hadejia"
NIGERIAN_CITY_12	"Kano"
NIGERIAN_CITY_13	"Calabar"
NIGERIAN_CITY_14	"Dutse"
NIGERIAN_CITY_15	"Lokoja"
NIGERIAN_CITY_16	"Owerri"
NIGERIAN_CITY_17	"Minna"
NIGERIAN_CITY_18	"Oshogbo"
NIGERIAN_CITY_19	"Gombe"
NIGERIAN_CITY_20	"Jalingo"
NIGERIAN_CITY_21	"Adamaua"
NIGERIAN_CITY_22	"Ikeja"
NIGERIAN_CITY_23	"Jos"
NIGERIAN_CITY_24	"Birnin Kebbi"
NIGERIAN_CITY_25	"Ado Ekiti"
NIGERIAN_CITY_26	"Enugu"
NIGERIAN_CITY_27	"Lafia"
NIGERIAN_CITY_28	"Gusau"
NIGERIAN_CITY_29	"Akure"
NIGERIAN_CITY_30	"Yenogoa"
	
KOREA	"Coreanos"
	
KOREAN_LEADERM_NAME	"Yi Songgye"
KOREAN_LEADERF_NAME	"Hung Hyegyong"
KOREAN_COUNTRY_NAME	"Corea"
KOREAN_SINGULAR	"Coreano "
KOREAN_PLURAL	"Coreanos"
KOREAN_CITY_1	"Seúl"
KOREAN_CITY_2	"Pusan"
KOREAN_CITY_3	"Taejon"
KOREAN_CITY_4	"Anyang"
KOREAN_CITY_5	"Hungnam"
KOREAN_CITY_6	"Chongju"
KOREAN_CITY_7	"Pyongyang"
KOREAN_CITY_8	"Chuncheon"
KOREAN_CITY_9	"Kaesöng"
KOREAN_CITY_10	"Inchon"
KOREAN_CITY_11	"Wonsan"
KOREAN_CITY_12	"Yongin"
KOREAN_CITY_13	"Puchon"
KOREAN_CITY_14	"Taegu"
KOREAN_CITY_15	"Yongsan"
KOREAN_CITY_16	"Ulsan"
KOREAN_CITY_17	"Hwasung-gun"
KOREAN_CITY_18	"Kinhae"
KOREAN_CITY_19	"Kwangju"
KOREAN_CITY_20	"Cheju"
KOREAN_CITY_21	"Changwon"
KOREAN_CITY_22	"Pohang"
KOREAN_CITY_23	"Tungwha"
KOREAN_CITY_24	"Sunchon"
KOREAN_CITY_25	"Uijongbu"
KOREAN_CITY_26	"Chonju"
KOREAN_CITY_27	"Mokpo"
KOREAN_CITY_28	"Suwon"
KOREAN_CITY_29	"Shihung"
KOREAN_CITY_30	"Sogwipo"
	
BRAZIL	"Brasileños"
	
BRAZILIAN_LEADERM_NAME	"M. Deodoro da Fonseca" 
BRAZILIAN_LEADERF_NAME	"Marqueza de Santos"
BRAZILIAN_COUNTRY_NAME	"Brasil"
BRAZILIAN_SINGULAR	"Brasileño"
BRAZILIAN_PLURAL	"Brasileños"
BRAZILIAN_CITY_1	"Brasilia"
BRAZILIAN_CITY_2	"Río de Janeiro"
BRAZILIAN_CITY_3	"Santos"
BRAZILIAN_CITY_4	"Porto Alegre"
BRAZILIAN_CITY_5	"Recife"
BRAZILIAN_CITY_6	"Laguna"
BRAZILIAN_CITY_7	"Caceres"
BRAZILIAN_CITY_8	"Guaiba"
BRAZILIAN_CITY_9	"Gramado"
BRAZILIAN_CITY_10	"Vitória"
BRAZILIAN_CITY_11	"Sao Carlos"
BRAZILIAN_CITY_12	"Fortaleza"
BRAZILIAN_CITY_13	"Sao Luis"
BRAZILIAN_CITY_14	"Belo Horizonte"
BRAZILIAN_CITY_15	"Monte Verde"
BRAZILIAN_CITY_16	"Manaus"
BRAZILIAN_CITY_17	"Cotia"
BRAZILIAN_CITY_18	"Passo Fundo"
BRAZILIAN_CITY_19	"Macapá"
BRAZILIAN_CITY_20	"Itaitaia"
BRAZILIAN_CITY_21	"Joao Pessoa"
BRAZILIAN_CITY_22	"Osasco"
BRAZILIAN_CITY_23	"Bauru"
BRAZILIAN_CITY_24	"Saubara"
BRAZILIAN_CITY_25	"Rio Grande"
BRAZILIAN_CITY_26	"Pelotas"
BRAZILIAN_CITY_27	"Rio do Sul"
BRAZILIAN_CITY_28	"Ouro Preto"
BRAZILIAN_CITY_29	"Aracaju"
BRAZILIAN_CITY_30	"Sorocaba"
	
AUSTRALIA	"Australianos"
	
AUSTRALIAN_LEADERM_NAME	"Gough Withlam"
AUSTRALIAN_LEADERF_NAME	"Carmen Lawrence"
AUSTRALIAN_COUNTRY_NAME	"Australia"
AUSTRALIAN_SINGULAR	"Australiano"
AUSTRALIAN_PLURAL	"Australianos"
AUSTRALIAN_CITY_1	"Sydney"
AUSTRALIAN_CITY_2	"Melbourne"
AUSTRALIAN_CITY_3	"Botany Bay"
AUSTRALIAN_CITY_4	"Brisbane"
AUSTRALIAN_CITY_5	"Newcastle"
AUSTRALIAN_CITY_6	"Canberra"
AUSTRALIAN_CITY_7	"Darwin"
AUSTRALIAN_CITY_8	"Perth"
AUSTRALIAN_CITY_9	"Hobart"
AUSTRALIAN_CITY_10	"Alice Springs"
AUSTRALIAN_CITY_11	"Longreach"
AUSTRALIAN_CITY_12	"Katherine"
AUSTRALIAN_CITY_13	"Adelaida"
AUSTRALIAN_CITY_14	"Ayr"
AUSTRALIAN_CITY_15	"Bega"
AUSTRALIAN_CITY_16	"Mount Isa"
AUSTRALIAN_CITY_17	"Cairns"
AUSTRALIAN_CITY_18	"Ultima"
AUSTRALIAN_CITY_19	"Coolangatta"
AUSTRALIAN_CITY_20	"Port Lincoln"
AUSTRALIAN_CITY_21	"Exmouth"
AUSTRALIAN_CITY_22	"Emu Plains"
AUSTRALIAN_CITY_23	"Tamworth"
AUSTRALIAN_CITY_24	"Woongoolba"
AUSTRALIAN_CITY_25	"Yarra"
AUSTRALIAN_CITY_26	"Hawkesbury"
AUSTRALIAN_CITY_27	"Lara"
AUSTRALIAN_CITY_28	"Wangaratta"
AUSTRALIAN_CITY_29	"Port Hedland"
AUSTRALIAN_CITY_30	"Redland"
	
MEXICO	"Mejicanos"
	
MEXICAN_LEADERM_NAME	"Zapata"
MEXICAN_LEADERF_NAME	"Juana Inés de la Cruz"
MEXICAN_COUNTRY_NAME	"Méjico"
MEXICAN_SINGULAR	"Mejicano"
MEXICAN_PLURAL	"Mejicanos"
MEXICAN_CITY_1	"Ciudad de Méjico"
MEXICAN_CITY_2	"Guadalajara"
MEXICAN_CITY_3	"Veracruz"
MEXICAN_CITY_4	"Tampico"
MEXICAN_CITY_5	"Oaxaca"
MEXICAN_CITY_6	"Monterrey"
MEXICAN_CITY_7	"Tijuana"
MEXICAN_CITY_8	"Juárez"
MEXICAN_CITY_9	"Chihuahua"
MEXICAN_CITY_10	"Cabo San Lucas"
MEXICAN_CITY_11	"Ixtapan de la Sal"
MEXICAN_CITY_12	"Hermosillo"
MEXICAN_CITY_13	"Cancun"
MEXICAN_CITY_14	"Tecate"
MEXICAN_CITY_15	"Nogales" 
MEXICAN_CITY_16	"Mazatlan"
MEXICAN_CITY_17	"Nuevo Laredo"
MEXICAN_CITY_18	"Zacatlan"
MEXICAN_CITY_19	"Todos Santos"
MEXICAN_CITY_20	"Villahermosa" 
MEXICAN_CITY_21	"Acapulco"
MEXICAN_CITY_22	"Rosarito"
MEXICAN_CITY_23	"Navajoa"
MEXICAN_CITY_24	"Isla Mujeres"
MEXICAN_CITY_25	"Akumal"
MEXICAN_CITY_26	"Chapala"
MEXICAN_CITY_27	"Querétaro"
MEXICAN_CITY_28	"Santa Catalina"
MEXICAN_CITY_29	"Guadalupe"
MEXICAN_CITY_30	"Zacatecas"
	
ETHIOPIA	"Etíopes"
	
ETHIOPIAN_LEADERM_NAME	"Haile Selassie I"
ETHIOPIAN_LEADERF_NAME	"Zauditu"
ETHIOPIAN_COUNTRY_NAME	"Etiopía"
ETHIOPIAN_SINGULAR	"Etíope"
ETHIOPIAN_PLURAL	"Etíopes"
ETHIOPIAN_CITY_1	"Addis Abeba"
ETHIOPIAN_CITY_2	"Tana"
ETHIOPIAN_CITY_3	"Makale"
ETHIOPIAN_CITY_4	"Aksum"
ETHIOPIAN_CITY_5	"Massaua"
ETHIOPIAN_CITY_6	"Bako"
ETHIOPIAN_CITY_7	"Dolo"
ETHIOPIAN_CITY_8	"Maji"
ETHIOPIAN_CITY_9	"Harar"
ETHIOPIAN_CITY_10	"Geledi"
ETHIOPIAN_CITY_11	"Diredawa"
ETHIOPIAN_CITY_12	"Warrandab"
ETHIOPIAN_CITY_13	"Asmara"
ETHIOPIAN_CITY_14	"Arba Minch"
ETHIOPIAN_CITY_15	"Gore"
ETHIOPIAN_CITY_16	"Mek'ele"
ETHIOPIAN_CITY_17	"Jima"
ETHIOPIAN_CITY_18	"Bonga"
ETHIOPIAN_CITY_19	"Gondar"
ETHIOPIAN_CITY_20	"Sidamo"
ETHIOPIAN_CITY_21	"Harerge"
ETHIOPIAN_CITY_22	"Gamo Gofa"
ETHIOPIAN_CITY_23	"Bale"
ETHIOPIAN_CITY_24	"Gojam"
ETHIOPIAN_CITY_25	"Tigré"
ETHIOPIAN_CITY_26	"Welo"
ETHIOPIAN_CITY_27	"Welega"
ETHIOPIAN_CITY_28	"Kefa"
ETHIOPIAN_CITY_29	"Shewa"
ETHIOPIAN_CITY_30	"Arsi"
	
MONGOL	"Mongoles"
	
MONGOL_LEADERM_NAME	"Gengis Kan"
MONGOL_LEADERF_NAME	"Bortei"
MONGOL_COUNTRY_NAME	"Mongolia"
MONGOL_SINGULAR	"Mongol"
MONGOL_PLURAL	"Mongoles"
MONGOL_CITY_1	"Karakorum"
MONGOL_CITY_2	"Samarcanda"
MONGOL_CITY_3	"Bokhara"
MONGOL_CITY_4	"Nishapur"
MONGOL_CITY_5	"Kashgar"
MONGOL_CITY_6	"Tabriz"
MONGOL_CITY_7	"Ulan Bator"
MONGOL_CITY_8	"Kabul"
MONGOL_CITY_9	"Ormuz"
MONGOL_CITY_10	"Basra"
MONGOL_CITY_11	"Khanbalyk"
MONGOL_CITY_12	"Khorasán"
MONGOL_CITY_13	"Shangtu"
MONGOL_CITY_14	"Kazán"
MONGOL_CITY_15	"Aleppo"
MONGOL_CITY_16	"Gushun Usu"
MONGOL_CITY_17	"Agaratu"
MONGOL_CITY_18	"Tamsog"
MONGOL_CITY_19	"Biger"
MONGOL_CITY_20	"Jibhalanta"
MONGOL_CITY_21	"Numurge"
MONGOL_CITY_22	"Muren"
MONGOL_CITY_23	"Darbi"
MONGOL_CITY_24	"Kerulen"
MONGOL_CITY_25	"Lung"
MONGOL_CITY_26	"Tamchi"
MONGOL_CITY_27	"Noyon"
MONGOL_CITY_28	"Obotuin"
MONGOL_CITY_29	"Ikhe Ude"
MONGOL_CITY_30	"Chikurting"
	
	
	
NICARAGUAN	"Nicaragüenses"
	
NICARAGUAN_LEADERM_NAME	"Moctezuma II"
NICARAGUAN_LEADERF_NAME	"Azzalleh"
NICARAGUAN_COUNTRY_NAME	"Nicaragua"
NICARAGUAN_SINGULAR	"Nicaragüense"
NICARAGUAN_PLURAL	"Nicaragüenses"
NICARAGUAN_CITY_1	"Managua"
NICARAGUAN_CITY_2	"San Carlos "
NICARAGUAN_CITY_3	"Nueva Guinea"
NICARAGUAN_CITY_4	"Juigalpa"
NICARAGUAN_CITY_5	"Matagalpa"
NICARAGUAN_CITY_6	"La Rosita"
NICARAGUAN_CITY_7	"Río Blanco"
NICARAGUAN_CITY_8	"Bonanza"
NICARAGUAN_CITY_9	"La Cruz"
NICARAGUAN_CITY_10	"Prinzapolka"
NICARAGUAN_CITY_11	"San Juan del Sur"
NICARAGUAN_CITY_12	"San Juan del Norte"
NICARAGUAN_CITY_13	"Rivas"
NICARAGUAN_CITY_14	"Ocotal"
NICARAGUAN_CITY_15	"Siuna"
NICARAGUAN_CITY_16	"Condega"
NICARAGUAN_CITY_17	"Chinandega"
NICARAGUAN_CITY_18	"Leimus"
NICARAGUAN_CITY_19	"Bocay"
NICARAGUAN_CITY_20	"Potosí"
NICARAGUAN_CITY_21	"Puerto Cabezas"
NICARAGUAN_CITY_22	"Rama"
NICARAGUAN_CITY_23	"Kukalaya"
NICARAGUAN_CITY_24	"Masaya"
NICARAGUAN_CITY_25	"Jinotega"
NICARAGUAN_CITY_26	"Waspam"
NICARAGUAN_CITY_27	"Leimus"
NICARAGUAN_CITY_28	"Teotecacinte"
NICARAGUAN_CITY_29	"Wiwill"
NICARAGUAN_CITY_30	"Granada"


